|--------|
|**|*****|
|**|--***|
|******@*|
|--------|